11111111111111111111111111111111
10000000111100001111000000000001
10111100000011110000011110011001
10100001111000001111000001100001
10101110000111100001111100011001
10101000111100001111000000001001
10101011110000111100001111011001
10100000000111100001111100001001
10111111000001110000011110001001
10000001111100001111000001111001
10111100000011110000011110000001
10000011110000001111000001111001
10111100001111100001111100000001
10000000000001110000000110011101
11110000111000000000110001111111
10000000000000110110000000000001
10001110000000100010111001100001
10000011000000110110010001000001
10000011110000011100011001100001
10000000000000000000000000000001
11111111111111111111111111000011
10000000000000000000000000000001
10111100000011110000011110000001
10000001111100001111000001111001
10111100001111100001111100000001
10000000000001110000011110011101
11111111110000111111111111111111
10000000111100001111000000000001
10111100000011110000011110011001
10100001111000001111000001100001
10101110000111100001111100011001
11111111111111111111111111111111
